17 17 17 17 17 17 17 17 17 17 17 17 17 17
17 31 31 31 31 31 31 80 81 31 31 31 31 17 
17 72 73 76 77 32 32 82 83 32 32 38 39 17 
17 74 75 78 79 1 1 1 1 1 1 40 41 17
17 1 0 0 0 0 0 0 0 0 0 42 43 17
17 1 0 44 45 46 47 48 49 0 0 0 0 17
17 70 0 50 51 52 53 54 55 0 0 0 68 17
17 71 0 56 57 58 59 60 61 0 0 0 69 17
17 1 0 62 63 64 65 66 67 0 0 0 0 17
17 1 0 0 0 0 0 0 11 12 13 0 0 17
17 17 17 17 17 17 17 17 14 15 16 17 17 17