89 90 91 92 89 90 91 92 89 90 91
93 94 95 96 94 95 96 94 95 96 97
98 100 101 102 103 104 105 106 107 108 99
109 111 112 113 113 113 113 113 114 115 110
116 118 119 120 120 120 120 120 121 122 117
123 125 126 127 128 129 130 131 132 133 124
89 90 91 92 89 90 91 92 89 90 91
89 90 91 92 89 90 91 92 89 90 91
89 90 91 92 89 90 91 92 89 90 91
89 90 91 92 89 90 91 92 89 90 91
89 90 91 92 89 90 91 92 89 90 91
89 90 91 92 89 90 91 92 89 90 91